1
#####
#.  #
# $ #
# @ #
#####