1
######
#.   #
# #$ #
# @  #
######