1
#######
#.    #
# $   #
#     #
# @   #
#######