1
#######
#     #
#  #  #
##$## #
# @  .#
#######