1
#######
#  ## #
#     #
##$## #
# @  .#
#######