1
#######
#.    #
# $   #
#  #  #
# @   #
#######