1
#######
#.    #
#  #  #
####$ #
# @   #
#######