1 1
###########
#.   ####.#
##   #### #
#  #### $ #
#  $  #   #
#     @   #
#  #  #   #
###########