1 1
###########
#@      #.#
##   ## # #
# .####   #
#  ##   $ #
# $   #   #
#   ###  ##
###########