1 1
#######
#. .  #
# $ $ #
#  #  #
# @   #
#  #  #
#######