1 2
#######
#. .  #
# $ $ #
#  #  #
# @   #
#  #  #
#. .  #
#######