1
##########
#.   #####
##   #####
#  ###  ##
#    #   #
#    @ $ #
#  # #   #
##########