1 5
########
###   ##
# $ # ##
# #  . #
#    # #
##$#.  #
#@   ###
########