10 5
########
####  ##
# $   ##
#  .# ##
## #.  #
# @  $ #
#   ####
########