1
########
###   ##
# $ # ##
# #  . #
#    # #
## #   #
##@  ###
########