5 1 
########
#####  #
#   $  #
# *.#  #
## ## ##
#      #
# @#   #
#  #####
########