10 1 3
#######
###  ##
## . ##
#@$$$ #
#. .# #
# #   #
#   ###
#######