1 2
#######
#.    #
#   $ #
#  @  #
#    $#
#  # .#
#######