1
#######
#  ## #
#     #
# $## #
# @  .#
#######