1
##########
#@     #.#
##   ### #
#  ####  #
#  ## $  #
#     #  #
#   ### ##
##########