1
#######
#.  $ #
#   # #
##### #
# @   #
#######