############
##         #
#          #
#   $      #
#  @      .#
############